1111111111111111111144
1000000000000000000144
1000000022222000000144
1004444433333000000144
1004444400000000000144
1004444400004000000144
1004444400000000000144
1004444400444040040144
1000000000404044440144
1000000000444040040144
1000000000000000000144
1111111111111111111144
