20,12
00000000000000000000
00000000000000000000
00000000222220000000
00044444333330000000
00044444000000000000
00044444000000000000
00044444000000000000
00044444000000000000
00000000000000000000
00000000000000000000
00000000000000000000
00000000000000000000
