1111111111111111111144
1000000000000000000144
1000000022222000000144
1004444433333000000144
1004444400000000000144
1004444400000000000144
1004444400000000000144
1004444400000000000144
1000000000000000000144
1000000000000000000144
1000000000000000000144
1111111111111111111144
