1111111111111111111144
1000000000000000000144
1000000022222000000144
1004444433333000000144
1004444400000000000144
1004444400000000000144
1000000400000000000144
1000000440000000000144
1000000044000000000144
1000000004000000000144
1000000000000000000144
1111111111111111111144
